++++++++++++++++++++
+--++++---++++++++++
S-+++++-+-+++++--+++
+-+++++-+-+++++---++
+-+---+-+-+++++-+-++
+-+-+-+---+++++-+-++
+-+-+-+-+-+---+-+-++
+-+-+-+-+-+-+-+-+-++
+-+-+-+-+-+-+-+-+-++
+-+-+-+-+-+-+-+-+-++
+-+-+-+-+-+-+-+-+-++
+-+-+-+-+-+-+-+-+-++
+-+-+-+-+-+-+-+-+-++
+-+-+-+-+-+-+-+-+-++
+-+-+-+-+-+-+-+-+---
+-+-+-+-+-+-+-+-+-++
+-+-+---+---+-+-+-++
+-+-+-+-+-+-+-+-+-++
+---+---+-+-+---+-++
++++++++++++++++++++
